HHHHHHHHHHHH
EEEEEEEEEEEE
HHHHHHHHHHHH
RRRRRRRRRRRR
HHHHHHHHHHHH
RRRRRRRRRRRR
HHHHHHHHHHHH
EEEEEEEEEEEE
HHERHHHHHHHH
HHHHHHHHHHHH
HHHHHHHHHHHH